1111111111111111111111111111111111
1E0000000000000C00000C000000000001
101001010010000010100100000000001
10100100101010100010010000000001
1P0000000C00C0000000000000000C1
11111111111111111111111111111